1111111111111111111111111111111111111
100000000000000000000000000CC00000101
100000000000000000000000000CC00000101
100000000000000000000000000CC00000101
100010000000000000000000000CC00000101
100101000000000000000000000CC00000101
110000100000000000000000000CC00000101
110000010000000000000000000CC00000101
110000001000000000000000000CC00111101
110000001000000000000000000CC00001011
100100010000000000000000000CC00111111
1000101000000000000000000000000000101
101C010000000000000000000000000000PE1
1111111111111111111111111111111111111