1111111111111111111111111111111111111111111111111111111111111111111111111111111111111111111111111111
1000000001000000010000011000000000010000000000000010000010000100100011000000001000000000010000000001
1110100000100000000000000001011000000100000000000000000000000010000000000001000100000000010000100001
1000000010000000000010000001000000000000000101000000000000000000000000001000100000010100000000100001
1000000000010000000000000110000000000000000010010000000000000100000000010000000000000100010000101001
1101000010000000000000000000010000000000010000001010000010100000010000000000010000000000001000000101
1000000000010000001000000000000000000000000000010010001000100000000000000000000000000000000000000001
1000000101000000000000000000001000000001000000001000000010010000000000000000000000000000000000000001
1000000101100011000001000000010010100000100000000000100001000000000000000000000000010000010000000001
1000000000000000000010000010000000000000000100000000000000000000000000100000000000000000100000001001
1010000000000000001000000000001000000000110000001000000000000110000000000000000000001000000010000001
1000000000000000001001000000000000010000000000000100000000000000001000000000000100000000000001010001
1000000000000000000000000000010100100000000000100000000010000000000000000000100000000000000000000011
1000010000101000000010000000000000010000000000000010000000000000000000000000000000000000000000000001
1010000000000000010000100101000000000010000000000100000000100100100000010001001100000000000000010001
1000000000000000010000000000000000000000000000000000000001000000000000000000000100000010000000101001
1000000000000000000010000000000100000000100000000000011000000000000000000000000000001000100000000001
1000000000000010000000000000001000000010001000000000000010001000100000000001000000000000100010000001
1000001000000100000000000000000000000000010001000000000001000100000001000000000000001000000000000101
100000000000000000000000000000000000000000000001001001C000000100001000100010000000000000000100000001
1000001001000000000001101001100001000100000010101000000000000000001000000000000000000000000001001001
1000000000000000000000001000000110000000100010000000000000000000000000000000110010000001000000000001
1000001000000000000000000000000000000000000001010000001100100000001001000100000000000100000000000001
10000000000010000000000000000100C0000000000000000100001100000100P00001000010011000000000000100100001
1000000000101100000000000001000000000000000000000000000000000010001000000000100000001000000000000001
1000000000001000000101000010000000000000000100000000000001000000000000000000000000000000000000000001
1000000000000000000000001000001000010000100000000011000100000000000000100000010001000100000100010001
1000000000000000000000100000000000000000000000100000010000010001000000000000000010000000000010000101
1000001000000000100000000001000010000100100000010000100110000000000000000000000000010100000001000001
1000000000000000001000010000000000100100000000100000000010000000000000010100100000000000110000000001
1000000010000000000000000100000000001000000000000000001000000000100000000010000000000000000100000001
1000010000000010000000000010001000000000000100000000001000000000000110000000100100010000000101000001
1010000000000001000001100000010000000000000100000000000000000000100000000000000000010000100000101001
10000000000100000000011000000000001000001000010000000C0000110010000000000000000000000000000001000111
1000000000000100100000000000000000010100000000100000000000010010100001000000000001000000000000001001
1001000000001001001100000000000000000100000000000000000000001000000000010000001000000010010000110001
1101000000100000000001000000000000000000000000010010100100000010010000000000001000000010001100000001
1000001000000110010000000010000000000000100000010000000100000000000000001000100000000100000000100001
1000000110000000000000100000000000000000000010001010001010000000000010000000000001000000010000000001
1000000000000010010000000000001000000000100000000000001100000000001000010000000000000001000000000111
1001000000000000010000001010010100000000000000000000100000000000100000010000000100001001000100100001
1000010000000000000010000010000000000001000000000000000000001000000000000010000000000000100000000101
1000000000000000000100000000000000010000000010000000000000000000100000000000010000000000000000000001
1000000000001010000000000000011011000000000110000001100010000000000000010000000101000010000000000011
1000000001000000000000001000000100000010010000010000010101000000001010000000000001101000000000000001
1000000000000C00000000011000000000000000000000000001010000000000000100000100000000011000000010000001
1000000000000000000000000001000000100100000000001100100010000000001000000000101000000000000000100001
1000000000000010000000000000100000101000000100000000000000001000001000000100000000000000000000010011
10001000000000010C0010001000000001000100000000000100000000000000000010000001000001000100000100000001
1010010000000000000000000000001100100100000000001000010000010000000000001000000000000000000000000101
1000000000001000000000001000000000000000000000000000100100000000000000001000000000000000000010001001
1000100001000101000000000000000000000110000000000000000100000001001000000000000000000010000000000001
1000000000000000000000000000000101000010000000000000100000000000000010000000000000000000000000100001
1000000000000000000000000000000001000000001000001000000000000001000000000000000000000000000000010001
1000100010000000010000000000000000000000010110001000000100001000001000100000001001100000100000001001
1010000000010101010100110001000001000000001001000000000000000000010000000000000010000000000000000001
1100000000000000000000000000000000000000000100000000000001100000010000100000001000000000000000000101
1000000000000000001000010000000100000000000000000000000010000000000000010000001000001000000000000011
1000000010000001000000100000100000000110000000100100011010000000001000000100000000000000010000000001
1000000100000000010000010001100000000100000000000000000000000001000010000000000000000000000010100001
1000000001000000000000010000101000000000000000000000000000000000100010000000000001011000000100000001
1000000000001000001000000000000000011000010010000000000000000000000000000010100000001000001010000001
1100010000010000000010000100000000001001000000000000000010000100001000000000000000000000000000000001
1000100000010010000000000000000000000100000000010000000100100001000000000000000000000000100000001101
1010000000100011000000000000000000010001000000001000000000000000000110000001000000000000000000010001
1000000000000001011000000001000000000000000001000000001000000001000111000000000000000000000000010001
10000010C0000000000000000000001000100010000000010000110000000010000000000001000000110010000000101001
100000010000001000000001000000000000000000000000000010100000000C000000100010000010000100000000000001
1000100000000001001000000001000000000001010100010100000000010000000000000000000000000000001000000001
1000000100000000100000000000000000000000000000000000000001000000000000001001000000011000000000100001
1000000000000000000110000000000000000010100000000000000100000000000000000000010000000000000001000001
1000100000001100000100000000000000100000000000001010000000001000000000010000000001010000010000000001
1000000100000000010010000000000000010001100000000010000000000000100000000000000000100000000000100101
1000000010000001000000000011000000000000010100000110000000000010000000000000100011000000000010000001
100001000100000010000100000010100000010000010000000000000000000000001000100000000000C000001000000001
1000000100000001100000000000000011000000000000001000000000000000000000000000000000000001000000010011
1100000111000000000000000000000000000000011100100000100000000000000000000000000010001000000000010001
1000000010110000001000000000000010001000000000000000000000000001001000000000010000001100000000010001
1000000000000010001000100001000000000000000010000000001001000000000000000100000001001000000000000001
1000010000000110000000000000000000000000000000000011000000000000000010000000000000000000000000000001
1000000000000000000001000000000011000000000000000000100000001000100101000000000000000000000000000001
1010000000100100000011000011000000000000000100000000000010100000000001000000000000000000000000000011
1000000000000000000000000001000000000000000000010000000000000000010000000001001000000000000001000001
1100000000000000010001000000000000010000000001000001000000000000000000010000000000000010010000000001
1000000000000000000000000000000000000001000000000000000000000000001100000001000100000000010010100001
1000000000001000100001100000000001010000110101110000000001000000000000000000000000000010000000000001
1000000000000000000000000000000001000000000000000000000001000001000000011000000000100000000000000001
1000000000000110000000101000000000000000000000000000100000000000000001000001000000000000010000000001
1101110000000000000000000100000000000100000100000000000000010100000000000000000000000000000001100001
1000001000000010001000010000000000000010000000001000100001000010000000001000000000000000000000110001
100000000000000000000000001000000000000010100000C010000000000000000100010000010000001000000000000001
1000000000101000010110000000101000000010000000000000000001101010000000000000101000000000010000000001
100000000000000000000000001001000100000010C000000000000000000000000000000010000010000000000001110101
1000000000110000001000100000000001000000000000000000000000000000000000000000000000000000001000001101
1000010000000000000000000000000000000000000000010000000110000000000000000000000100000000000000000001
1100000001000000000000000000000100001001100001000000110000100010000000100000000000000000000000000001
1001000100000000000000000100000000000000000010000010000100000000000100000000000000000000110000000001
1001000000001100000000000000000000000000010000000000100000000001000001000000010000000001100000001001
10100000000E0000100000100001000000000000000000001000100001000000000000010010001000100000000000001001
1111111111111111111111111111111111111111111111111111111111111111111111111111111111111111111111111111
